1111111
1000001
1001001
1010101
1001001
100N001
1111111