NO texture/chiseled_bookshelf_occupied.png
SO texture/birch_planks.png
WE texture/hay_block_side.png
EA texture/Bricks.png

F 164,169,20
C 153,204,255

11111
10001
10001
10001
100011111
1000N0001
100000001
111111111

