11111
1N001
10001
10001
01111
